X_XXXXXXXXX__
__X___E______
_XXXXXXXXXXX_
____X___X____
XXXXXXX______
_____________
_XXXX________
X_CX__XXXXXX_
____XXXXX____
_XX________X_