_X__X_X_X
CXX______
____XX__X
XX__X_X__
XXXXXEX__
X______X_
__XXXXX__
________X