_X__X_X_X
CXX______
____XX__X
XX____X__
EXXXXXX__
_______X_
_XXXXXX__
________X